.........#.............*...*..*...........#..........***...#......*..........#.......**.............*...#....................*......#.......
.#............#........*...*..*......................***..........*..................**...........#.*........................*..............
.......................*...*..*......................***..........*..................**.............*..............#.........*.#............
.......................*.#.*..*......................***........#.*......#...........**.............*........................*..............
...................#...*...*..*......................***..........*..................**.............*....................#...*..............
.......................*...*..*........#.............***..........*..................**...#.........*........................*....#.........
.............#.........*...*..*.#....................***..........*...#..............**............#*....#.......#...........*............#.
.......................*...*..*............#.........***..........*..................**.............*........................*..............
#......................*...*..*.....#................***..........*..............#...**.............*.................#......*..............
.......................*...*..*......................***..........*..................**.....#.......*........................*..............
.......................*...*..*......................***..........*..........#.......**#............*........................*..............
....#..................*.#.*..*..........#.........#.***..........*#.................**.............*........................*..........#...
..................#....*...*..*......................***..........*..................**.............*........................*..............
.......................*...*..*......................***.#........*..................**...#.........*............#...........*.#............
.......................*...*..*......................***..........*................#.**.............*..#.....................*..............
.....................#.*...*..*......#........#......***..........*........#.........**.............*........................*..............
..#.....#......#.......*...*..*.#....................***..........*..................**#............*........................*..............
.......................*.#.*..*......................***........#.*..................**.............*........#..........#....*.........#....
.......................*...*..*......................***..#.......*..................**.............*........................*..............
********************************************************************************************************************************************
.......................*...*..*....#.................***..........*..#........#......**....#........*..............#.........*..............
.............#.........*...*..*............#.........***..........*..................**.............*#.......................*..............
.......................*...*..*...................#..***..........*..................**.............*........................*.#.....#......
.......................*.#.*..*......................***..........*..................**.............*..........#.............*..............
.......#...............*...*..*...............#......***..........*................#.**......#......*...#....................*..............
....................#..*...*..*......................***..#.......*......#...........**.............*........................*..............
.......................*...*.#*.....#................***..........*..................**.............*........................*..............
.......................*...*..*......................***..........*..................**.............*.......................#*....#.........
...........#...........*...*..*.............#........***..........*..................**.............*........................*..............
....#..................*...*..*..#...................***..........*..................**...........#.*........#...............*..............
.......................*...*..*......................***..........*..................**.............*.............#..........*............#.
................#......*.#.*..*.........#............***....#.....*..................**.............*..#.....................*..............
.......................*...*..*....................#.***..........*.........#........**.............*........................*..#...........
.........#.............*...*..*...............#......***..........*..................**......#......*........................*........#.....
..#....................*...*..*......................***..........*..................**.............*.........#..............*..............
.......................*...*..*......................***..........*..................**............#*...................#....*..............
.......................*...*..*............#.........***.........#*..................**..#..........*........................*.....#........
...................#...*...*.#*......................***....#.....*......#.....#.....**.............*........................*..............
..............#........*...*..*..................#...***..........*..................**.............*................#.......*..............
.......................*#..*..*......................***..........*..................**.............*........................*..............
.......................*...*..*........#.............***..........*..................**....#.....#..*..#.................#...*..............
.......................*...*..*.#............#......#***..........*..................**.............*...........#............*..#...........
........#.........#....*...*..*......................***..........*..#...............**.............*........................*..........#...
.......................*..#*..*......................***..........*..................**.............*.......#................*..............
.......................*...*..*...........#..........***........#.*......#........#..**.............*.......................#*..............
.......................*...*..*......................***.#........*..................**.......#.....*........................*..............
.......................*...*..*.....#..........#.....***..........*..................**.............*........................*..............
..#......#.............*...*#.*......................***..........*.........#........**.#...........*....#........#..........*..............
.......................*...*..*......................***..........*...#..............**.............*........................*..............
********************************************************************************************************************************************
.......................*...*..*......................***..#.......*..................**.....#.......*...................#....*........#.....
********************************************************************************************************************************************
......................#*...*..*......................***..........*.................#**..........#..*.......#................*..............
#..........#...........*...*..*......................***..........*..................**.............*........................*..............
.................#.....*...*..*....#.................***..........*.#................**.............*........................*#.............
********************************************************************************************************************************************
.......................*..#*..*.........#............***..........*.........#........**......#......*................#.......*..............
********************************************************************************************************************************************
.......................*...*..*......................***#.........*..................**.............*........................*.............#
..........#............*...*..*.#............#.......***.....#....*..............#...**.............*........................*..............
#...................#..*...*..*......................***..........*..................**.............*..#.....................*..............
********************************************************************************************************************************************
.......................*...*..*..........#...........***..........*#......#..........**..........#..*.................#......*..............
.......................*..#*..*......................***..........*..................**.....#.......*...........#............*....#.........
.......................*...*..*...................#..***..........*..................**.............*.......................#*..............
********************************************************************************************************************************************
.....#.................*...*..*......................***..........*.........#........**.............*#..................#....*..............
.......................*...*..*......................***........#.*...#..............**.............*.....#..................*..............
..........#............*...*..*...#..................***#.........*..................**.............*........................*.#......#.....
................#......*...*..*..................#...***..........*..................**.........#...*........................*..............
#.....................#*...*.#*......................***..........*............#.....**.............*........................*..............
********************************************************************************************************************************************
.......................*...*..*......................***......#...*..................**.............*.................#......*..........#...
......#................*...*..*.....#......#.......#.***..........*#.................**....#........*....#.................#.*...#..........
....................#..*...*..*......................***.#........*..................**.............*........................*..............
.......................*...*..*#.....................***..........*..................**.............*...........#............*..............
.......................*..#*..*......................***..........*..................**...........#.*........................*..............
.#.....................*...*..*...............#......***..........*......#...........**.............*........................*..............
........#.....#........*...*..*......................***......#...*..................**..#..........*.#......#...............*........#.....
********************************************************************************************************************************************
.......................*...*..*......................***#.........*..................**.............*.....................#..*..............
********************************************************************************************************************************************
............#..........*...*.#*........#.............***..........*..................**.............*....#.......#...........*....#........#
.......................*...*..*..................#...***..........*.........#........**....#........*..................#.....*..............
...#.............#.....*.#.*..*............#.........***..........*..................**.............*........................*..............
********************************************************************************************************************************************
.......................*...*..*......#...............***..#.......*.....#............**.........#...*........................*..............
.....................#.*...*..*....................#.***..........*..................**.............*...#....................*..............
............#..........*...*..*......................***..........*..................**.............*..........#.............*..............
.......................*...*..*......................***..........*..........#.....#.**.............*.......................#*..............
..................#....*...*..*......................***......#...*..................**.............*........................*.............#
.......................*...*..*#........#............***..........*...#..............**.............*........................*..............
.........#.............*.#.*..*......................***..#.......*..................**.............*........................*..............
...#...................*...*..*....#.................***..........*..................**.............*..#.....................*..............
.......................*...*..*......................***..........*........#.........**#............*........................*..............
.......................*...*..*......................***..........*.............#....**.............*........................*..............
.......................*...*.#*................#.....***..........*#.................**.............*........................*..#..........#
............#..........*...*..*......................***..........*..................**.....#.......*........................*..............
.....................#.*...*..*.........#............***......#...*................#.**.............*..............#......#..*..............
................#......*...*..*......................***..........*..................**.#.........#.*........................*..............
.......................*...*..*......................***..........*.......#..........**.............*......#.................*..............
.......................*...*..*.................#....***.........#*..................**.............*........................*...#..........
.......................*.#.*..*.#....................***..........*............#.....**.............*............#...........*..............
..................#....*...*..*......#...............***..........*..#...............**....#........*........................*.......#......
............#..........*...*..*......................***..........*................#.**.............*.#......................*..............
.....#.................*...*..*......................***..........*..................**.............*.......#................*..............
......................#*...*#.*.............#......#.***..........*..................**.......#.....*.....................#..*............#.
.......................*...*..*......................***....#.....*..................**#............*........................*..............
.......................*...*..*.......#..............***..........*..................**.............*...........#............*..............
.......................*...*..*......................***..........*...#..............**.............*..................#.....*#.............
....................#..*...*..*......................***.......#..*................#.**....#........*........................*..............
#......................*...*..*...........#..........***..........*.........#........**.............*........................*...........#..
.......................*...*..*....................#.***..........*..................**.............*..#...................#.*..............
.......................*...*..*......................***....#.....*#.................**.............*................#.......*..............
.....#.................*...*..*#.....................***..........*..................**......#......*...........#............*..............
.......................*...*..*......................***..........*......#...........**.............*........................*....#.........
********************************************************************************************************************************************
.......................*...*..*......#...............***..........*..................**.............*........................*..............
.......................*#..*..*......................***...#......*..................**....#........*.......#.......#......#.*..............
.......................*...*.#*...................#..***..........*..................**.............*..#.....................*.............#
..................#....*...*..*..............#.......***..........*..................**.............*........................*.....#........
.......................*...*..*......................***.......#..*........#.........**.......#.....*........................*..............
.......................*...*..*..#...................***..........*..................**............#*........................*..............
.......................*...*..*......................***..........*..................**#............*........................*..............
..#....................*...*..*....................#.***....#.....*..................**.............*........................*..............
...........#...........*...*..*............#.........***..........*...............#..**.............*...........#.......#....*......#.......
.......................*#..*..*......................***..........*..................**.............*........................*..............
......#................*...*..*........#.............***..........*.........#........**........#....*#.......................*..............
..................#....*...*..*......................***#.........*#.................**.............*.......................#*..............
.......................*...*.#*......................***..........*..................**.............*........................*.............#
............#..........*...*..*......................***..........*..................**.............*........................*....#.........
.......................*...*..*...............#......***..........*.....#............**...#.........*........................*..............
.....#.................*...*..*......................***.....#....*..................**.............*........................*..............
.......................*...*..*......#...............***..........*..................**.............*....#..............#....*..............
.......................*...*..*......................***..........*..................**.............*..............#.........*..............
...................#...*..#*..*.#........#...........***..........*#...............#.**.............*........................*..............
.......................*...*..*......................***..........*..................**.............*........................*.......#......
...........#...........*...*..*....................#.***..........*..................**.............*...........#..........#.*..............
......................#*...*..*......................***#.........*....#.....#.......**..........#..*........................*...........#..
.......................*...*#.*......#...............***.........#*..................**.....#.......*........................*..............